Level3,3
####################
#        #  ooooo  #
# @ @    #         #
# @ @    #         #
#A  ########   @   #
#                  #
#                  #
#                  #
####################