Level1,1
#######################
#                     #
#                     #
#oo              @A   #
#@                    #
#                 #####
#######################