Level2,2
###################
#o #o # o# o#o # o#
#                 #
#                 #
#                 #
###             ###
#A  @@     @@@    #
#                 #
###################