level,1
#######################
#                     #
#                     #
# o @A                #
#                     #
#                 #####
#######################