level,4
##########
#        #
#  o @ A #
#        #
##########